maximum	limit	total	max	increase	long	count	tally
characters	words	bytes
image	picture
integer	number
webclipicon	webclip	apple touch icon
fault	error	bug	warning	notice	mistake	glitch	flaw	failure
delineate	delimit	delimitate	demarcate
order	sort	position	direction
sudo	masquerade	su
multi-moderation	multimoderation
invitation	invite
social	forum
xml_fields	filtering
banner	advert	advertising	advertise
masthead	header
news	blogs	press release	journal
check-in	workflow	unvalidated	validation	valid	approve	approval	approved	live	accept	posted	online	active	activate	activation	visible	verify	publish
webstandards	check	conformance
theme	skin	style
basket	cart
uninstall	disable	remove
pruning	prune	lurkers
lost password	forgot password	forgotten password	reset password
pm	pt	dm	private message	private topic	whisper
filedump	library	file manager	asset
word-filter	wordfilter	swear	curse
colour	color	css	font	background
dob	date of birth	age	birthday
sef	seo	google	search engine	search-engine-friendly	search-engine-optimisation
ban	suspend	suspension	probation	warn	punish	punitive	troll
crash	warn	error	fatal	falt
staff	moderator	admin	administrator	operator	webmaster
open	closed	live	activate	activation	turn	maintenance
import	convert	migrate	interchange
commandr	console	command prompt	command line	cle
required	optional	mandatory
export	download
attachment	upload
tree	nest	hierarchy	node	child	recursive	branch
pinned	sticky
interstitial	gateway
cpfs	cpf	fields
counting_blocks	hit counter
email	e-mail	cns_contact_member
redirect	route
center	centre
license	licence
search	find	filter
recommend	refer
quizzes	surveys	tests	competitions	questionnaires	prize-draw	exam	assessment
securitylogging	audit
content reviews	audit
award	highlight	feature
bookmark	favorite
calendar	event	diary	schedule
admin zone	admincp	admin panel	control panel
collaboration_zone	groupware
actionlog	audit
atom	rss	feed	syndication
ical	icalendar
display	render	view
gallery	album	galleries	podcast	multimedia
audit	log	usage
download	file	document	publication	library
page	article	comcode
entry	item	content	resource	submission	sku
category	node	section	repository	collection
directory	folder
catalogue	database	classified	catalog	directory	schema	field
speed	slow	fast	optimisation	performance	efficiency	latency
panel	sidebar	frame	bar	column
usergroup	group	promote	rank	badge
member	user	contact	person
profile	account	memberaccount
accessibility	a11y
intl	internationalisation	regionalisation	i18n	l10n	localisation	translation
permission	privilege	authorisation	authorization	right	access	grant	restrict	prohibited	credentials
access	view
overlay	popup	dialog	window
option	setting	value	parameter	preference
configure	configuration	setup	install	core_configuration
emoticon	smiley	smile	face	emoji
forum	board	bbs	cns_forum	message board
thread	topic
karma	point
batch	bulk	mass
subscribe	track	notification	alert	monitor	watch	follow
bbcode	wikicode	comcode	shortcode
html	xhtml
knowledgebase	wiki
wysiwyg	rte
addon	add-on	mod	hack	extension	plugin	app	core_addon_management	module	system	package	install
name	title	label	codename
engagement	metric	kpi	analytics	statistics	hits	stats
newsletter	mass-mail	mass-mailing	bulletin	mail-merge	announcement
announcement	cascading
description	caption	summary
choose	set	specify	pick
add	submit	create	make	publish	upload	build
edit	modify	manage	change	control	moderate	update
changes	revisions	diff	history	undelete	version
delete	erase	remove	discard	prune	trash
restore	revert	undo
news	story	stories	article
language	unicode	utf	utf8	utf-8	character	charset	24	clock	timezone	time-zone	time	date	translate
ldap	active directory
contact	feedback	ticket	message	issue	email	e-mail	support	desk
post	message	body
documentation	help	guide	manual
sef	short	friendly
survey	quiz	competition	test	questionnaire
swf	flash
friend	buddy	follower
like	love	rate
subscribe	subscription
attach	embed
smf	simple machines forum
ipb	invision
random_quotes	testimonials
join	register	signup	sign-up	create-account
logout	log-out	sign-out	sign-off
login	log-in	sign-in	sign-on	logon	log-on	authorize
credentials	password
shopping	ecommerce	payment	purchase	products
cache	decache	cleanup
ssl	https
seed	theme wizard
chart	graph
author	bio	biography
block	widget
moniker	slug
guest	anonymous
rules	license	licence	agreement	terms	conditions	legals t&cs
dashboard	console	status
menu	navigation
permalink	url	link
importance	priority	precedence	level
chance	probability	likelihood
empty	blank	purge	flush
raw	plain	pure
